Abko.	Eso es!
Abta.	Por eso.
¿Abti?	¿Que paso después?
Abu.	desobedencia.
Acho.	grosería!
Aibe.	Sólo.
Aisete.	Por Qué.
Aiteje.	Susto.
Aja.	Molestar.
Äkani.	Por esa causa.
¡Ake!	¡No molestes!
Akisete.	Por razon de que.
Aku.	Aguja.
Akwre.	Venga.
Alan.	Cresta de gallo.
¿Amare?	¿dónde está?
¿Ame?	¿Adonde está?
Amne.	Entonces y.
An.	Y.
Anchina.	Alegría.
Antlan.	Gallo.
Ani.	Vamos.
Angwane.	Cuando.
Ara.	Ese mismo.
Arabe.	Lo mismo.
Arato.	también
¡Ari!	¡Vamos!
Aro.	Arroz.
Asio.	estornudo.
Asio ngidienkä.	Estornudar.
Ate.	Dolor.
Aune.	Cuando.
Babi.	Pavo.
Badre.	Sacerdote.
Bali.	Bolsillo.
Bayi.	Ropa interior.
Ban.	Pan.
Bani.	Aluminio.
Bañon.	Pañuelo.
Baran.	Guineo.
Barankrä.	Finca.
Bare.	Terminado.
Barera.	Ya cumplido.
Basakä.	Visitante.
Basare.	Pasear
Basa täräe.	Pasaporte.
Batarabe.	Enseguida.
Bati.	Una vez.
Batata.	Alrededor.
Batibe.	De repente.
Bato.	Pato.
Bä.	Apariencia.
Bä aibe.	Un solo color.
Bä Diankakrä.	Cámara.
Bä diankä.	Sacar foto.
Be nice.	Señalar.
Bä mie.	Geh weg!
Bä ngösöi.	Claro.
Bä ngraba.	Limpio.
Bä räkä.	Poco.
Bäbtä.	Digno.
¿Bäbe?	¿Cuantas veces?
Bäbkä.	Cuatro veces.
Bäin.	Ayuno.
Bälen.	Sabroso.
Bämä.	Tres veces.
Bämän.	Domingo.
Bämänte.	Velorio.
Bämän tike.	Hace velorio.
Bämiara toae.	Televisión.
Bän.	Pez anguila.
Bäna.	Sabor.
Bänä noen.	Saborear.
Bänänte.	Sabroso.
Bäri.	Muy.
Bärike.	Cinco Veces.
Bärisi.	Parecido.
Bäse.	Lamer.
Bäsekä.	Barrer.
Bäsi.	Casi.
Bäsokö.	Sobar.
Bäsököta.	Reelegir.
Bätä.	Desprecio.
Bätäre.	Despacio.
Bätete.	Lavar.
Be.	Zapallo.
Ben.	Con él.
Ben.	Con ella.
Betaninte.	Soltar.
Bete.	Temblar.
Betekä.	Correr.
Betekä.	Estallar.
Betekä.	Explotar.
Bi.	Suegra.
Bian.	Mujer Extranjera.
meri.	Mujer.
köbö.	Día.
Törie.	Enero.
Nötarie.	Febrero.
Trärie.	marzo.
Tukerie.	Abril.
Mirie.	Mayo.
Ñurie.	Junio.
Bererie.	Julio.
Joborie.	Agosto.
Jokoire.	Septiembre.
Tomäirie.	Octubre.
Mikirie.	Noviembre.
Krisiminsi.	Diciembre.
¡Biare!	¡Ahora!.
Ma ta nune mdende.	¿Donde vives?.
Ti ta nune.	yo vivo en.
Bien.	Regalar.
Bien.	Dar.
Bile.	Alfiler.
Bile.	Gancho Pequeño.
Billo.	Anciana.
Bilón.	Pilón.
Bintin.	Reciente.
Bintin.	Pronto.
Bintin.	Nuevo
Bisi Bisi.	Coloreado.
Bisi Bisi.	Pintado.
Bisire.	Modelo de mochila.
Bisire.	Modelo de vestido.
Blato.	Plato.
BlärÄ.	Harina.
Blita.	Diálogo.
Blita.	Conversación.
Blitakrä.	Teléfono.
Blitakrä.	Telegrafía.
Blitäire.	Informar.
Blitäire.	Comunicar.
Blitäire.	Notificar.
Blitagwä.	Emisora.
Blite.	Hablar.
Blite gwärere.	Hablar frente a frente.
Blite ngwarbe.	Mentir.
Blo.	Malo.
Blite ngwarbe.	Bochinches.
Blo.	Incorrecto.
Blo.	Embarazo.
Blore.	Actuar mal
Blotu.	Meseta.
Blotu.	Pico de cerro
Blure.	Azul.
Blü.	Flor.
Blü.	Sapo Cantador.
Blübe.	Hinchado.
Blübe.	Inflamado.
Blübe.	Soplado.
Bobo.	Pájaro.
Bobre.	Humilde.
Bobre.	Pobre.
Bobota.	Sapo.
Bobu.	Dos veces.
Bokro.	Fósforo.
Bolore.	Redondo.
Bolore.	Círculo.
Bosi.	Nuera.
Bosi.	Cuñada.
Bökän.	Simpatía.
Bökän.	Verdad.
Bökänä.	Verdaderamente.
Bökänä.	Es cierto.
Bötä.	En.
Bötä.	Pegado.
Bötä.	Cerca.
Bötä.	Seguido.
Bötä ngwen.	Despreciar.
Brae.	Cazador.
Braibe.	Poco.
Braire.	Amenazar.
Brare.	Varón.
Brä.	Nieto.
Brämäne.	Desmayado.
Brän.	Vamos.
Bren.	Enfermo.
Bren.	Enfermedades.
Bren Käme.	Enfermedad.
Bren Käme.	Contagiosa.
Brete.	Pan.
Brichi.	Puente.
Brimo.	Liso.
Brimo.	Resbaloso.
Brimone.	Gordura.
Brimone.	En condición.
Brukwä.	Corazón.
Brutu.	Pecho.
Brükwä.	Corazón.
Bta.	Por eso.
Btabe.	En seguida.
Biti.	Entonces.
Biti.	Seguido.
Biti.	Después.
Biti.	Sobre.
Biti.	Con.
Biti.	Encima.
Bube.	Tulivieja
Buchu.	Bechita
Buke.	Alimentar.
Buke.	Soplar.
Bukere.	Celeste.
Buko.	Flecha.
Buko.	Chuzo.
Bukroän.	Pulmón
Bule.	Barriga
Bun.	Plátano
Bun.	Varicela.
Büra.	Venado.
Bure.	Nueva planta.
Bure.	Nuevo animal.
Büre jäke.	Respirar.
Büre Täke.	Soplar.
Bütiekrä.	Esqueleto.
Bütiere.	Desnudo.
Bü.	Pez.
Bü.	Guabo.
Bü.	Roncador.
Bukrä.	Pulmones.
Büle.	Barriga.
Büre.	Migaja.
Büre kete.	Detener la respiración.
Bürere.	Desmenuzado.
Bürere.	Molido.
Büsal.	Mojarra.
Büsal.	Chogorro.
Büsal.	Planta.
Chakla.	Pollitos.
Chan.	Gallotes.
Chambra.	Caña de pescar.
Chara.	Frijol pintado.
Chenka.	Conchita.
Chen.	Persona morena.
Chi.	Pequeño.
Chichikwata.	Ruiseñor.
Chiki.	Perrito.
Chokali.	Espiritu maligno.
Cholibo.	Garza blanca.
Chui.	Desconocido.
Chui.	Extraño.
Churu churu.	Arrugado.
Dekete.	Anchar.
Dekete.	Extender.
Dekete.	Ampliar.
Dela.	Capisucia.
Demaine.	Cariño.
Demaine.	Besar.
Deme.	Puro.
Deme.	Limpio.
Deme.	Intocable.
Den.	Tomar.!
Den.	Buscar.
Denkä.	Sacar.
Denkä kuin.	Sacar de la tierra.
Dentari.	Recoger.
Dentari.	Salvar.
Deo.	Noche.
Dera.	Rato.
Dere.	Tarde.
Deu.	Noche.
Di.	Fuerza.
Di.	Poder.
Diän.	Malcriado.
Di ñan.	Débil.
Dibire.	Nocturno.
Diemie.	Ayudar.
Diemie.	Inclinar
Diemie.	Apoyar.
Diemie.	Amparar.
Dikaro.	Mucho.
Dikaro.	Bastante.
Dikaro.	Varias veces.
Dike.	Maquillaje.
Dike.	Coser.
Dike.	Labial.
Dikekä.	Andar.
Dikente.	Destruir.
Dime.	Ácido.
Dime.	Apretado.
Dime.	Estrecho.
Diore.	Lejano.
Diore.	Un poco oscuro.
Diore.	Opaco.
Dirare.	Claro y limpio.
Diri jue.	Escuela.
Dirikä.	Maestro.
Dirikä.	Maestra.
Dirikä.	Profesor.
Dirikä.	Profesora.
Dirikä.	Profeta.
Dirikä.	Pastor.
Dirikä.	Pastora.
Dite.	Poderoso.
Diteta.	Recuperar la fuerza.
Doan.	Cuñado.
Doän.	Ropa.
Doän.	Vestido.
Dobo.	Tierra.
Dibo mie.	Enterrar.
Doboä.	Sardina..
Doboka.	Pesado.
Dobore.	Chocolate.
Dobro.	Laguna.
Dobro.	Charco.
Dobrore.	Sucia.
Doen.	Chupar.
Dokwä.	Cabeza.
Dokwä.	Tronco.
Dokwä druen.	Cabello.
Dokwä mie.	Peluquear.
Dokwä mie.	Cortar el cabello.
Dokwä sökö.	Peinarse.
Dokwä täke.	Prohibir.
Dokwä täke.	Impedir..
Domi.	Bejuco.
Dö.	Ron.
Dö jue.	Cantina
Döre.	Borracho.
Döre.	Ebrio
Drankwa.	Fiebre.
Drankwa kiare.	Sarampión.
Dräire.	Distribuir.
Dräire.	Repartir.
Dräre.	Cansado.
Dräre.	Agotado.
Drätike.	Eructar.
Dre.	Que.
¿Dre?	¿Que?
Drekbe.	Muy rapido.
Dribe.	Alacran.
Driere.	Enseñar.
Driere.	Señalar.
Drika.	Sábado.
Drinri.	Insecto.
Droa.	Lonche.
Droa.	Merienda.
Droasi.	Mono cara blanca.
Dru.	Mariposa nocturna.
Drun.	Ñame.
Drun.	Ñampí.
Drü.	Cuerno.
Rüen.	Pelo.
Rüen.	Pluma.
Rüen.	Vello.
Drüne.	Negro.
Drüne.	Moreno.
Drüne.	Oscuro.!
Du.	Bote.
Du.	Canoa.
Dua.	Abuelo.
Dua.	Pelícano.
Dube.	Selva.
Dube.	Maleza.
Duin.	Creer.
Duin.	Sentir
Duin.	Lastimar.
Duin.	Presentir.
Duka.	Aguacate.
Dun.	Red.
Durinsi.	Perico.
Dünkwä.	Puntiagudo.
Dürü butiere.	Calvo.
¡E!	¡Ahh!
Eble.	Mal tejido.
Echa.	Zorra.
Erara.	Ciertamente.
Erauto.	También.
Erebe.	Igual.
Erere.	Asi mismo.
Eteba.	Hermano.
Etbakrä.	Primo hermano.
Etebareta.	Primo.
Gaba.	Sabía.
Gare.	Saber.
Gätä.	Reunión.
Gätä.	Asamblea.
Gätäre.	Reunirse.
Genkä.	Hacer desaparecer
Gente.	Ocultar.
Gente.	Esconder.
Genten.	Adormecer.
Genten.	Morir.
¿Gere?	¿Que?
Gibiekä.	Aflojarse.
Gibiekä.	Salir de la reunión.
Gibiekä.	Divorcearse.
Giteckä.	Empujar.
Gobran.	Gorbenador.
Gobran.	Presidente.
Gobran.	Corregidor.
Gokä.	Ladrón.
Goire.	Robar.
Goire.	Estafar.
Gräkite.	Jugar.
Gräkite.	Actuar.
Gräkite.	Hacer guerra.
Grie.	Diarrea.
Grie därire.	Disentería.
Griere.	Con diarrea.
Grine.	Afilado.
Grü.	Tío.
Gu.	Hueco.
Gure.	Casados.
Gü.	Lechuza.
Gwa.	Pez.
Gwa.	Pescado.
Gwaire.	Juntos.
Gwaire.	Al mismo tiempo.
Gwara.	Lombrices.
Gwara.	Parásito.
Gwä.	Ahorita.
Gwä.	Hacia la casa.
Gwäre.	Rostro.
Gwärere.	Públicamente.
Gwero.	Huevo podrido.
Gwi.	En casa.
Gwi.	Dentro de casa.
Gwrä.	Ritos.
Gwre.	Rana
Gwrie.	Morado.
Gwire.	Hogar.
I.	Maíz.
Lä.	Grano de maíz.
Ibi.	Camaleón.
Ibia.	Caña.
Ibia mnun.	Azúcar.
Ibia nie.	Refresco de caña.
Ibia ngätä.	Raspadura.
I blu.	Flor de maíz.
Icha.	Culebra.
¡Icha!	¡Wow!
I döi.	Chicha de maíz.
Idro.	Luciérnaga.
I dru.	Brusca de maíz.
Ie.	Para el.
Ie.	A el.
Ieli.	Especie de pájaro.
I kä.	Hoja de maíz.
Ikle.	Hormiga grande.
Ikle.	Inglés.
Iklere.	Idioma inglés.
Ikoli.	Insecto.
Ikrä.	Finca de maíz.
I mrä.	Maíz nuevo.
Ison.	Nariz.
Iti.	Una persona.
Itire Itire.	Cada uno.
Itrani.	Orine.
Intra ken.	Orinar.
Iyan.	Pene.
Ja dätere.	Vestirse.
Ja dätere.	Arreglarse.
Ja driere.	Quejarse.
Ja erebe.	Igual.
Ja jiebti.	Para atras.
Ja keke.	Rascar.
Ja keke.	Cosquilla.
Ja mäke.	Hacer amistad.
Ja mie kri.	Jactarse.
Ja mie kri.	Orgullo.
Ja muko.	Amigo.
Ja muko.	Compañero.
Jamun.	Jabón.
Ja müre kete.	Suicidarse.
Ja müre kete.	Asesinar.
Ja nuente.	Practicar.
Ja nuente.	Adiestrar.
Ja nuente.	Enseñar.
Ja ngä ñain.	Beber.
Ja ngibiare.	Dar a luz.
Ja ngibiare.	Esperar.
Ja rüere.	Enemigo.
Ja rüere.	Rival.
Ja rüere.	Adversario.
Ja tarere.	Amar.
Ja tötikaka.	Estudiante.
Ja tötikaka.	Estudioso.
Ja töbikaire.	Preocupado.
Ja tötike.	Estudiar.
Ja tökrä.	Un recuerdo.
Jadenkä.	Jugar.
Jadenkä.	Deporte.
Jadüke.	Descansar.
Jakare.	Vergüenza.
Jakenkä.	Alzar uno a otro.
Jakwite.	Disfrazar.
Jakwite.	Cambiar.
Jakwite.	Turnar.
Jaknu.	Continuo.
Jaknu.	Siempre.
Jaknu.	Cada vez.
Jali.	Risacua.
Janama.	Fue.
Janäre.	Igual tamaño.
Janäre.	Parejo.
Jare.	Parientes.
Jataba.	Vino.
Jata.	Orilla del mar.
Jata.	Playa.
Jato.	Potrero.
Jatoaba.	Vio.
Jatoaba.	Vimos.
Jatobti.	Voluntad.
Jatobti.	Voluntario.
Jä.	Piedra.
Jä.	Roca.
Jä münü.	Polvo de roca.
Jädriane.	Ayer.
Jäe.	Malestar.
Jäkäni.	Haló.
Jäke.	Halar.
Jäme.	Quieto.
Jäme.	Manso.
Jäme.	Humilde.
Jämi.	Todavía.
Jämi.	Aún.
Jämi mribo.	No esta maduro.
Jän.	Sí.
Jändrän.	Cosas.
Jätäira.	Diez días.
Jändrän.	Cosas.
Jätäkä.	Baño.
Jätäkäte.	Ir al baño.
Jen.	Propio.
Jene.	Diferente.
Jene jene.	Dividido.
Jene jene.	Parte separada.
Jenena.	Ajeno.
Jenena.	De otro.
Jetebe.	Mañana.
Ji.	Camino.
Ji krai.	Mochila.
Ji kri.	Carretera.
Ji ngwen.	Guiar.
Ji ngwen.	Dirigir.
Jialire.	Oxidado.
Jibe.	Cosquillear.
Jikri.	Cigarra.
Jikwili.	Pajaro.
Jiebti.	Seguir.
Jiemike.	Imitar.
Jioro.	Hierro.
Jiro.	Gabiota.
Jida.	Cerebro.
Jitrasi.	Moracho.
Jlaka.	Lagarto.
Jlata.	Cañizo.
Jlima.	Lima.
Jlimo.	Limón.
Jlira jlira.	Muy flaco.
Jlitikete.	Cosquillar.
Jrute.	Pedir alimento.
Jobe.	Aguacero.
Joborie.	Agosto.
Jodrón.	Cosillas.
Jodron date jue.	Casa de fábrica.
Joeme.	Cobarde.
Jorakä.	Penca.
Joko.	Araña.
Jokorie.	Noviembre.
Jole.	Tontorojas.
Jökrä.	Todo.
Jörän.	Mosquito.
Jörän.	Zancudo.
Jötrö.	Muy rápido.
Jötrö Jötrö.	Constantemente.
Jrekäbe.	Solamente.
Ju.	Edificio.
Jube.	Greñudo
Jube.	Ropa grande.
Jubra.	Pájaro raqueta
Juda.	Nido.
Judakwata.	bolsa amniótica.
Juden.	Gallote.
Juden.	Zopilote.
Jullali.	Vagina.
Juentari.	Largar.
Junkue.	Nudo.
Jukwe.	Puerta.
Jukwe tigara.	Llave.
Jumen.	Grave.
Junun.	Trasero.
Junun.	Nalga.
Jurin.	Mono aullador.
Juta Ngöbökwe.	Pueblo de Dios.
Juta.	Comunidad.
Juto.	Liviano.
Jutra.	Fuego.
Jutra.	Luz.
Ju.	Bazo.
Jüben.	Bañarse.
Jükara.	Pintura.
Jüke.	Silbar.
Jükete.	Bañarte.
Jürä nuen.	Espiar.
Jürä nuen.	Insinuar.
Jürü.	Suegro.
Kä kämen.	el tiempo está malo.
Kä rä.	olores.
Kabré.	montón.
Kada.	boca.
Kaibe.	solo.
Ñö.	lluvia.
Kämen.	malos.
Käne.	primero.
Kare.	verde.
Kärere íe.	pídalo a él.
Käte.	gordo.
Kati.	una hoja.
Kegue.	vaciar.
Kete.	empaque.
Ketéiti.	un paquete.
Kise.	mano.
Kideiti.	rácimos.
Kíra.	viene.
Kíra.	antiguo.
Kíra.	viejo.
Kite.	tire.
Kobógwä.	cuatro.
Köböiti.	un día.
Komä.	tres.
Köte.	gordo.
Krä.	flaco.
Krati.	un animal.
Krene.	perezoso.
Krí.	grande.
Krí kä.	hoja de árbol.
Krübäte.	demasiado.
Kubú.	dos.
Kugwe.	palabra.
Kuni.	encontró.
Küra.	terminó.
Kürera.	terminaron.
Kwä kügü.	siete.
Kwä ögän.	nueve.
Kwä.	ocho.
Kwaga.	amargo.
Kwäjätä.	diez.
Kwärä.	al lado.
Kwärigué.	cinco.
Kwätí.	seis.
Kwati.	uno.
Kwe.	él.
Kwegwe.	de él.
Kwetádi.	comerán.
Kwete.	comer.
Kwetre.	ellos.
Kwitira.	comieron.
Kwrägri.	 a otro lado.
Mä.	usted.
Mägwe bian tíe.	usted me lo da a mí.
Mä niguí medénde.	¿Usted adónde va?
Mäe.	a usted.
Mägwe.	suyo.
Mägwe.	suya.
Malan.	mariposa.
Mare.	más tarde.
Matáre.	hoy.
Mende.	lejos.
Merire.	femenina.
Mete.	péguelo.
Metre.	cierto.
Metre.	verdad.
Miti.	pegó.
Möre.	hembra.
Mrägä.	familia.
Mun.	ustedes.
Mungwä.	mosca.
Murare.	engripado.
Mura.	gripe.
Muríe.	viento.
Muríe.	aire.
Kwäräi.	Esposo.
Kwäräi.	Esposa.
Me.	Mamá.
Meke.	Madre.
Nukro.	Perro.
Nänä.	Relog.
Ñgänga.	Hija.
Ngöbö täräi.	Biblia.
Ngöbö.	Dios.
brare.	Hombre.
Ma niki mdende.	¿A donde vas?.
Näin.	andar.
Tata.	Padre.
Tata.	Papá.
Tatika.	Viejo.
Tatika.	Anciano.
Nän.	vaya.
Né.	éste.
Né.	tome.
Né ñain.	tome este.
Néa.	ésta.
Negä.	desaparece.
Négri.	a este lado.
Negwe.	de esta.
Nende.	derramar.
Nére.	por aquí.
Néte.	aquí.
Ngäne.	ladrar.
Ngaña.	hormiga.
Ngin.	gusano.
Ngire.	caliente.
Ngugwe.	desplumar.
Ngwai.	hermana.
Ngwana roäre.	en medio día.
Ngwäre.	cara.
Ngwean.	dinero.
Ngwen.	blanco.
Ngwena.	lleve.
Ngwendä íe.	pregunte a él.
Ngwin.	Traer.
Nidan.	macho.
Niguigä.	bolar.
Niguigä.	asustar.
Niguíra.	se fue.
Nirégwe.	de quién.
Nírien.	crecer.
Nírien.	desarrollar.
Nuäre.	Linda.
Nuäre.	Lindo.
Nugwä.	pájaro.
Nun.	nosotros.
Nun kiri.	a lado de nosotros.
Nungwe.	de nosotros.
Ñadre.	tomar.
Ñain.	tome.
Ñó né.	tome esta agua.
Ñö ñain.	tome agua.
Ñü.	Lluvia.
Öba.	avispa.
Ogwä.	ojo.
Ötare.	la mita.
Ötöiti.	un vestido.
Rien.	cocine.
Roro.	cuello.
Rubún.	bravo.
Rubúne.	enojado.
Rürübäine.	vendiendo.
Ségri.	al otro lado.
Ségwe.	de aquella.
Séte.	allá.
Sübrüre.	amarillo.
Tä diguegä.	está caminando.
Tägärä.	para sentar.
Tägue tibien.	siéntese.
Tain.	rojo.
Ti.	yo.
Ti tä sribíre.	yo estoy trabajando.
Ti tä tärä driere.	yo estoy enseñando.
Tigue.	escriba.
Tigwe.	mío.
Töe krägue.	él quiere
Trägwata.	una bolsa plástica.
Ulíe.	 pierna.
Ugwe.	moler.
Ugwen.	olla.
Umbre.	mayor.
Umbre.	anciano.
Üna.	completo.
Üna.	madurar.
Yé.	ése.
Ye kwegwe.	ese es de él.
Ye kwetregwe.	ese es de ellos.
Ye tigwe.	ese es mío.
Ye tigwe.	eso es mío.
Yéte.	ahí.
kwati.	uno.
kubú.	dos.
komä.	tres.
kobógwä.	cuatro.
kwärigué.	cinco.
kwätí.	seis.
kwä kügü.	siete
kwä kwä.	ocho.
kwä ögän.	nueve.
kwäjätä.	diez
Mane.	dulce.
Mocoño.	como te llamas.
moronibiti.	tengo hambre.
Köbo kuin dekä.	Buenos días.
Köbo kuin dere.	Buenas tardes.
Köbo kuin deu.	Buenas Noches.
¿Mä tua ño?	¿Comoestas?
Ani basare.	Vamos a pasear.
Ji ngrabare.	En el camino.
Ni dogwóbotdó.	La cabeza.
Ni ngrabare.	El cuerpo.
Gwi.	En la casa.
Bron jadengo.	Vamos a jugar.
Basare mölöe gondi.	A la casa de la abuela.
Ari jodron ne taen.	Vamos a contar.
Ñóge jodron ñógorótde an ñóge köbotdó.	Pesar y medir.
Ñötde.	En la quebrada.
Ni bren.	Los enfermos.
Ani sribi gondi.	Vamos al campo.
Kó.	El tiempo.
Ja mórógó.	La familia.
Junda mige.	Vamos a la junta.
Ani krünbotdó.	Vamos a la balsería.
Ani basare Steven gondi.	Vamos a visitar a Steven.
Jón, bron.	Sí, vamos.
Jura, betdego.	Apúrate, corre.
Köbö kwin dego, ja mórógó.	Buen día estas mañana, amiga.
¿Mó köböni ño, Steven?	¿Cómo soñaste, Steven?
Ti köböni bononde.	Soñé sabroso.
¿Mó kó ño suliare?	¿Cómo te llamas en castellano?
Ti kó Steven.	Me llamo Steven.
¿Mó kó ño ngóbere?	¿Cómo te llamas en guaymí?
Ti kó Steven.	Me llamo Steven.
¿Mó tó nüne medende?	¿Dónde vives?
Ti tó nüne Tódobotdó.	Vivo en Cerro Otoe.
¿Mó dórebare medende?	¿Dónde naciste?
Ti dórebare Kwradubitdi.	Nací en Cerro Gato.
¿Kó kwóbe móya?	¿Cuántos años tienes?
Kó krójótdo bitdi krókügü tibitdi.	Tengo diecisiete años.
Na mó, mó ñaka blitdani, ¿mó kó ño?	Y tú, no has hablado, ¿cómo te llamas?
Ti kó Steven Cisneros.	Me llamo Steven Cisneros.
Kwin mógróge mun nü ti gondi, ja toaida jetdebe.	Les agradezco que vengan a mi casa, nos vemos mañana.
Kwin Ngöbögróge, ja toaida madangware.	Gracias a Dios, nos vemos más adelante.
¿Dre kugwe, Steven?	¿Qué tal, Steven?
Köbö kwin, Steven.	Buen día, Steven.
¿Mó nigi medende, Steven?	¿A dónde vas, Steven?
Ti nigi Tugwerabitdi.	Voy a Ratón.
¿Mó nigi giere noaine?	¿Qué vas a hacer?
Ti nigi gótdóbotdó setde.	Voy a una reunión allá.
¿Gótdó giere botdó?	¿Reunión sobre qué?
Gótdó sribigró ñö ogwó gwa ngubuara.	Una reunión para trabajar en un estanque de peces.
Na mó, ¿medende gitde, Steven?	Y tú, ¿de dónde vienes, Steven?
Ti Katdubitdi kitde.	Vengo de Caña Brava.
¿Mó nigi giere noaine Katdubitdi?	¿A qué fuiste a Caña Brava?
Ti jani basare botdó blitde roaben.	Fui a visitar y a hablar con un abuelo.
¿Giere góre?	¿Para qué?
Ka kugwenoin botdó kugwe kira.	Para oir sus cantos y sus historias.
¿Mó janama köböben setde?	¿Cuánto días estuviste allá?
Ti janama móderare setde.	Tres días estuve allí.
¿Köböben mó tódi Tugwerabitdi?	Y tú, ¿cuántos días vas a estar en Ratón?
Ngübügen ti kwainda.	Pasado mañana regresaré.
¿Mó noin medende jetdebe?	¿A dónde irás mañana?
Ti tö rabai netde, kri nura tigwe nögaba bomo kónenbotdó ngubuarebitdi.	Estoy pensando quedarme aquí para cuidar las semillas de árboles que sembré la semana pasada.
Kwin ti ngobo, ja ngubua botdó mógwe ñan dö ñai krubotde.	Bien hijo, cuídate y no tomes mucha chicha.
Ñakare Steven, ti ñaka jire chi neme dröbare.	No Steven, yo nunca me emborracho.
Mó ningögö, Steven, Ngöbö riga móben, ja toaida ngübügen.	Mentiroso, Steven, Que Dios vaya contigo, nos vemos pasado mañana.
Ngöbö reba móben, Steven, Ja toaida.	Que Dios quede contigo, Steven, Nos vemos.
Kwin Ngöbögróge dego, kiatdre.	Bendito sea Dios hoy, niños.
Köbö kwin dego, dirigó.	Buen día, maestra.
Ari ja di kórere Ngöböe kwe jodron rügai gare nie.	Vamos a pedir a Dios que nos haga más inteligentes.
Ari niere gwaire, Ngöbö, mó nun Rün .	Digamos juntos , Dios, tú eres nuestro Padre.
Matdare nun bige jatötdigai ni dogwóbotdó, Batdi, niere tie, ¿Sobro migatda medende jae?	Hoy vamos a estudiar la cabeza Primero, díganme, ¿Dónde se pone el sombrero?
Ja dogwóbitdi.	Sobre la cabeza.
¿Dre ja dogwó sögö?	¿Qué peinamos?
Ni ja dogwó druen sögö.	Peinamos el pelo.
¿Dre bitdi ni tó nigren?	¿Con qué vemos?
Ni ogwóbitdi.	Con los ojos.
¿Ni ogwóbitdi ta ne kó ño?	¿Cómo se llama lo que está encima de los ojos?
Ogwógwatda.	Párpados.
¿Ni ogwó bo ño?	¿De qué color son los ojos?
Drüne.	Negros.
Bugere.	Azules.
Dobore.	Pardos.
Kare.	Verdes.
¿Nigwe roin dre bitdi nie?	¿Con qué oímos?
Ni olobitdi.	Con los oídos.
¿Dre bitdi ni tó jodron róse?	¿Con qué olemos?
Ni isonbitdi.	Con la nariz.
¿Dre bitdi ni tó mröre?	¿Con qué comemos?
Ni mröre kadabitdi tubitdi.	Comemos con la boca y los dientes.
¿Dre bitdi ni tó blitde?	¿Con qué hablamos?
Tidróbitdi.	Con la lengua.
¿Dre tó ni ogwó bitdi kwin?	¿Qué tenemos arriba de los ojos?
Ni ogwó druen.	Las cejas.
¿Ni ogwóregri kó ño?	¿Cómo se llama la parte de adelante de los ojos?
Ngwóre.	La cara.
¿Ni tó ja mige ye gondi kó ño?	¿Cómo se llama donde uno se pinta?
Ni tó ja migatda ngwórebotdó.	Nos pintamos la cara.
¿Dre tó ni dogwó ketetde?	¿Qué sostiene la cabeza?
Rorogró.	El cuello.
Ni ngwóre tó kitde druende, ¿ye kó ño?	Cuando salen pelos en la cara, ¿cómo se llama eso?
¿Ngóbe tö tó neme ni klótdea?	¿A los Guaymí les gustan los barbudos?
Ñagare, ni bó kóme.	No, son feos.
¿Ñobotdó?	¿Por qué?
Akwe ngwóre klón tugwó kwerere aratdo i kló kwerere.	Porque la cara parece espina de puerco espín y también barba del maíz.
Köbö kwin dego, ngobogre.	Buen día, niños.
Ñantöre dego, dirigó.	Buenos días, maestra.
Ari ja töe kórere Maria, Jesu meye, kwe ni meye di migai sribibotdó.	Vamos a pedirle a María, la mamá de Jesús, que ayude a nuestras mamás en sus trabajos.
Kwin Ngöbögróge dego, Maria.	Hola, María.
Nigwe jatödigaba ni ogwóbotdó jodrin Matdare, ni bige jatödige ni ngrabare.	Ayer estudiamos la cabeza, Hoy vamos a estudiar el cuerpo humano.
¿Dre bitdi ni tó jodron ketetde?	¿Con qué agarramos las cosas?
Ni kisebitdi.	Con las manos.
¿Dre ni tó noin?	¿Con qué caminamos?
Ni ngotdobitdi.	Con los pies.
¿Ni ngwóregri ye kó ño?	¿Cómo se llama la parte de adelante del cuerpo?
Motdróró.	El pecho.
¿Ni trögri ye kó ño?	¿Cómo se llama la parte de atrás?
Trögró.	La espalda.
¿Medende korea migatda jae?	¿Dónde se pone la correa?
Migatda ja mregarabotdó.	En la cintura.
Ni tó ngitdiegó, ¿dre tó kitde ne nie?	Si nos cortamos, ¿qué nos sale?
Ni dórie.	La sangre.
¿Ni dórie tó noin ño?	¿Por dónde camina la sangre?
Tó noin ni bigin ngrabare, ni brugwó an ni bügrón.	Por las venas, el corazón y los pulmones.
Ni tó mröre, ¿mrö tó nigen ño?	Cuando comemos, ¿a dónde va la comida?
Tó nigen ni kadatdebitdi, ni roro jiebitdi, bitdi tó nigen motdo, abitdi ni ngóngróbitdi, tó nigen ni ngrabare.	De la boca al esófago, de ahí al estómago, luego al intestino y al resto del cuerpo.
¿Ñaka tó nemendea?	¿Y no queda nada?
Tó nemende, kitdagatda.	Lo que queda, se bota.
¿Ño?	¿Cómo?
Ni köde, ¿dre tó ni toen ni botdó?	A los gordos, ¿qué se les nota?
Ja krüborebitdi, ja itdraninbitdi an ja ngónbitdi.	Por el sudor, la orina y el excremento.
Ni büle.	La barriga.
Ni króchi, ¿dre tó ni toen ni botdó?	A los flacos, ¿qué se les nota?
Ni króna.	Las costillas.
Ni krógoi migatda kitde, agu migatda medende mie?	Cuando vienen los enfermeros, ¿dónde ponen las inyecciones?
Ni junungróbitdi.	En las nalgas.
Bori kwin, kiatdre, mungwe jatötdigani krubotde, kó nibi nuóre tibotdó yebotdó, Ja toaida jetdebe.	Muy bien, niños, estudiaron mucho, estoy contenta por eso, Nos vemos mañana.
Abko.	Eso es!
Abta.	Por eso.
¿Abti?	¿Que paso después?
Abu.	desobedencia.
Acho.	grosería!
Aibe.	Sólo.
Aisete.	Por Qué.
Aiteje.	Susto.
Aja.	Molestar.
Äkani.	Por esa causa.
¡Ake!	¡No molestes!
Akisete.	Por razon de que.
Aku.	Aguja.
Akwre.	Venga.
Alan.	Cresta de gallo.
¿Amare?	¿dónde está?